0000000000000000000000000000000000000000000000000000000000000000000000000000000000000000000000000000000000000000
0000000000000000000000000000000000000000000000000000000000000000000000000000000000000000000000000000000000000000
0011111111111111111111111111111111111111111111111111111111111111111111111111111111111111111111111111111111111100
0011111111111111111111111111111111111111111111111111111111111111111111111111111111111111111111111111111111111100
0011100000000000000000000000000000000000000000000000000110000000000000000000000000000000000000000000000000011100
0011000000000000000000000000000000000000000000000000000110000000000000000000000000000000000000000000000000001100
0011000000000000000000000000000000000000000000000000000110000000000000000000000000000000000000000000000000001100
0011111111111111000000000000000000000000000000000000000110000000000000000000000000000000000000001111111111111100
0011000000000011000000000000000000000000000000000000000110000000000000000000000000000000000000001100000000001100
0011000000000011100000000000000000000000000000000001111111111000000000000000000000000000000000011100000000001100
0011111100000011110000000000000000000000000000000011000110001100000000000000000000000000000000111100000011111100
0011111100000011011000000000000000000000000000000110000110000110000000000000000000000000000001101100000011111100
0011001100000011011000000000000000000000000000000110000110000110000000000000000000000000000001101100000011001100
0011001100000011001100000000000000000000000000001100000110000011000000000000000000000000000011001100000011001100
0011001100000011001100000000000000000000000000001100000110000011000000000000000000000000000011001100000011001100
0011001100000011001100000000000000000000000000001100001111000011000000000000000000000000000011001100000011001100
0011001100000011001100000000000000000000000000001100000110000011000000000000000000000000000011001100000011001100
0011001100000011011100000000000000000000000000001110000110000111000000000000000000000000000011101100000011001100
0011001100000011011000000000000000000000000000000110000110000110000000000000000000000000000001101100000011001100
0011111100000011111000000000000000000000000000000111000110001110000000000000000000000000000001111100000011111100
0011111100000011110000000000000000000000000000000011110110111100000000000000000000000000000000111100000011111100
0011000000000011100000000000000000000000000000000001111111111000000000000000000000000000000000011100000000001100
0011000000000011000000000000000000000000000000000000000110000000000000000000000000000000000000001100000000001100
0011111111111111000000000000000000000000000000000000000110000000000000000000000000000000000000001111111111111100
0011000000000000000000000000000000000000000000000000000110000000000000000000000000000000000000000000000000001100
0011000000000000000000000000000000000000000000000000000110000000000000000000000000000000000000000000000000001100
0011100000000000000000000000000000000000000000000000000110000000000000000000000000000000000000000000000000011100
0011110000000000000000000000000000000000000000000000000110000000000000000000000000000000000000000000000000111100
0011111111111111111111111111111111111111111111111111111111111111111111111111111111111111111111111111111111111100
0011111111111111111111111111111111111111111111111111111111111111111111111111111111111111111111111111111111111100
0000000000000000000000000000000000000000000000000000000000000000000000000000000000000000000000000000000000000000
0000000000000000000000000000000000000000000000000000000000000000000000000000000000000000000000000000000000000000

