                                                                                
     %%          %%                 %%          %%                %%          %%     
       %%      %%                     %%      %%                    %%      %%  
     %%%%%%%%%%%%%%                 %%%%%%%%%%%%%%                %%%%%%%%%%%%%% 
   %%%%#%%%%%%%%#%%%%             %%%%#%%%%%%%%#%%%%            %%%%#%%%%%%%%#%%%% 
 %%  %%%%%%%%%%%%%%  %%         %%  %%%%%%%%%%%%%%  %%        %%  %%%%%%%%%%%%%%  %%    
 %%  %%          %%  %%         %%  %%          %%  %%        %%  %%          %%  %%
       %%%%  %%%%                     %%%%  %%%%                    %%%%  %%%%  
                                                                               
     %%          %%                 %%          %%                %%          %%     
       %%      %%                     %%      %%                    %%      %%  
     %%%%%%%%%%%%%%                 %%%%%%%%%%%%%%                %%%%%%%%%%%%%% 
   %%%%#%%%%%%%%#%%%%             %%%%#%%%%%%%%#%%%%            %%%%#%%%%%%%%#%%%% 
 %%  %%%%%%%%%%%%%%  %%         %%  %%%%%%%%%%%%%%  %%        %%  %%%%%%%%%%%%%%  %%    
 %%  %%          %%  %%         %%  %%          %%  %%        %%  %%          %%  %%
       %%%%  %%%%                     %%%%  %%%%                    %%%%  %%%%  
                                                                                
     %%          %%                 %%          %%                %%          %%     
       %%      %%                     %%      %%                    %%      %%  
     %%%%%%%%%%%%%%                 %%%%%%%%%%%%%%                %%%%%%%%%%%%%% 
   %%%%#%%%%%%%%#%%%%             %%%%#%%%%%%%%#%%%%            %%%%#%%%%%%%%#%%%% 
 %%  %%%%%%%%%%%%%%  %%         %%  %%%%%%%%%%%%%%  %%        %%  %%%%%%%%%%%%%%  %%    
 %%  %%          %%  %%         %%  %%          %%  %%        %%  %%          %%  %%
       %%%%  %%%%                     %%%%  %%%%                    %%%%  %%%%  
                                                                               
     %%          %%                 %%          %%                %%          %%     
       %%      %%                     %%      %%                    %%      %%  
     %%%%%%%%%%%%%%                 %%%%%%%%%%%%%%                %%%%%%%%%%%%%% 
   %%%%#%%%%%%%%#%%%%             %%%%#%%%%%%%%#%%%%            %%%%#%%%%%%%%#%%%% 
 %%  %%%%%%%%%%%%%%  %%         %%  %%%%%%%%%%%%%%  %%        %%  %%%%%%%%%%%%%%  %%    
 %%  %%          %%  %%         %%  %%          %%  %%        %%  %%          %%  %%
       %%%%  %%%%                     %%%%  %%%%                    %%%%  %%%%  



