                       ??
                       ??
                       ??
                       ??
                       ??
                       ??
                       ??
                       ??
                     @@??@@
                   @@%%??%%@@                 
                 @@%%%%??%%%%@                
            @@@@%%%%%%%??%%%%%%%@@@@        
          @@#%%%%%%%@@@??@@@%%%%%%%#@@         
         @###%%%%%@####??####@%%%%%###@
        @@%%%%@@%%%%%@@??@@%%%%%@@%%%%@@    
         @@@@@%%%%%##@@%%@@##%%%%%@@@@@   
          @@%%%%%##@@######@@##%%%%%@@
          @@%%%##@@##%%@@%%##@@##%%%@@       
            @@%%%%%%%%%%%%%%%%%%%%@@     
                  @@@%%%%%%@@@          
                @@%%%%%%%%%%%%@@    
              @@%%%%%%%%%%%%%%%%@
            @@%%%%@@@%%%%%%@@@%%%%@@         
            @@%%@@???@@%%@@???@@%%@@        
            @@%%@@??@%%%%%%@??@@%%@@       
            @@%%%@@@%%%%%%%%@@@%%%@@  
            @@%%%%%%%%%%%%%%%%%%%%@@  
              @@%%%%%%%%%%%%%%%%@@   
                @@@%%%%%%%%%%@@@ 
//////////////////@@@@@@@@@@@@			    