                                                                                
                                                                                
                                                                                
               ..                        ..                        ..           
                                   @@@@@@@@@@@@@@@@@                            
            .                @@@@@@%%%%%%%%%%%%%%%%%@@@@@                       
                           @@%%%%%%%%%%%%%%%%%%%%%%%%%%%%@@@                    
                           @@%%%%%%%%%%%%%%%%%%%%%%%%%%%%@@@                    
                        @@@%%@@@@@@%%%%%%%%%%%%%%%%%@@@@@%%%@@@                 
                        @@@@@      @@@%%%%%%%%%%%@@@     @@@@@@                 
               ...      @@@           @@&%%%%%@@@           @@@     ..          
              .         @@@           @@@&%%%&@@@           @@@                 
                        @@@             @@%%%@@             @@@                 
                        @@@              @@@@@              @@@                 
                    .   @@@              @@@@@              @@@                 
                          #@@@@@       @@@%%%@@@       @@@@@                    
                          #@@%%@@@@@@@@@%%%%%%%@@@@@@@@@%%@@                    
                             @@@%%%%%%%%%%%%%%%%%%%%%%%@@                       
                                @@@@@@%%%%%%%%%%%@@@@@@           ..            
              .              @@@%%%%%%@@@@@@@@@@@%%%%%@@@                       
                           @@%%%%%%%%%@@%%%@%%%@@%%%%%%%%@@@                    
                        @@@&&&&&@@@%%%%%@@@@@@@%%%%%@@@&&&&&@@@        .        
                     @@@%%%%%&&&@@@&&&%%%%@@@%%%%&&&@@@&&&%%&&&@@@              
                     @@@%%%%%&&&@@@&&&%%%%@@@%%%%&&&@@@@@&%%%%%@@@              
                     @@@%%%%%@@@@@@&&&%%%%%%%%%%%&&&@@@@@%%%%%%@@@              
              .        .@@@@@@@@@@@%%%@@%%%%%%@@@%%%@@@@@@@@@@@   .             
            . . .            @@@&&&&&&&&@@@@@@@@@&&&&&&&&@@@        .           
                           @@@@@%%%%%%@@@@@@@@@@@@@%%%%%@@@@@@  .              
                           @@@%%%%%%%%@@         @@@%%%%%%%%@@@                 
                           @@@@@@@@@@@@@         @@@@@@@@@@@@@@   