,,,,,,,,,,,,,,,,,,,,,,,,,,,,,,,,,,,,,,,,,,,,,,,,,,,,,,,,,,,,,,,,,,,,,,,,,,,,,,,,,,,,,,,,,,,,,,,,,,,,,,,,,,,,,,,,,,,,,,,,
,,,,,,,,,,,,,,,,,,,,,,,,,,,,,,,,,,,,,,,,,,,,,,,,,,,,,,,,,,,,,,,,,,,,,,,,,,,,,,,,,,,,,,,,,,,,,,,,,,,,,,,,,,,,,,,,,,,,,,,,
,,,,,,,,,,,,,,,,,,,,,,,,,,,,,,,,,,,,,,,,,,,,,,,,,,,,,,,,,,,,,,,,,,,,,,,,,,,,,,,,,,,,,,,,,,,,,,,,,,,,,,,,,,,,,,,,,,,,,,,,
,,,,,,,,,,,,,,,,,,,,,,,,,,,,,,,,,,,,,,,,,,,,,,,,,,,,,,,,,,,,,,,,,,,,,,,,,,,,,,,,,,,,,,,,,,,,,,,,,,,,,,,,,,,,,,,,,,,,,,,,
,,,,,,,,,,,,,,,,,,,,,,,,,,,,,,,,,,,,,,,,,,,,,,,,,,,,,,,,,,,,,,,,,,,,,,,,,,,,,,,,,,,,,,,,,,,,,,,,,,,,,,,,,,,,,,,,,,,,,,,,
,,,,,,,,,,,,,,,,,,,,,,,,,,,,,,,,,,,,,,,,,,,,,,,,,,,,,,,,,,,,,,,#########,,,,,,,,,,,,,,,,##########,,,,,,,,,,,,,,,,,,,,,,,
,,,,,,,,,,,,,,,,,,,,,,,,,,,,,,,,,,,,,,,,,,,,,,,,,,,,,,,,,,,,,#,,,,,,,,,,,#,,,,,,,,,,,,#,,,,,,,,,,,#,,,,,,,,,,,,,,,,,,,,,
,,,,,,,,,,,,,,,,,,,,,,,,,,,,,,,,,,,,,,,,,,,,,,,,,,,,,,,,,,,#,,,,,,,,,,,,,,#,,,,,,,,,#*,,,,,,,,,,,,,#,,,,,,,,,,,,,,,,,,,,
,,,,,,,,,,,,,,,,,,,,,,,,,,,,,,,,,,,,,,,,,,,,,,,,,,,,,,,,,,,###,,,,,,,,,,,,,,#,,,,,,#,,,,,,,,,,,,,,,#,,,,,,,,,,,,,,,,,,,,
,,,,,,,,,,,,,,,,,,,,,,,,,,,,,,,,,,,,,,,,,,,,,,,,,,,,,,,,,,,,,,###,,,,,,,,,,,,######,,,,,,,,,,,####,,,,,,,,,,,,,,,,,,,,,,
,,,,,,,,,,,,,,,,,,,,,,,,,,,,,,,,,,,,,,,,,,,,,,,,,,,,,,,,,,,,,,,,,,########,,,,,#,,,,,########,,,,,,,,,,,,,,,,,,,,,,,,,,,
,,,,,,,,,,,,,,,,,(((((,,,,,,,,,,,,(((((,,,,,,,,,,,,,,,,,,,,,,,,,,,,,,,,,,,#,,,#,#,,,#,,,,,,,,,,,,,,,,,,,,,,,,,,,,,,,,,,,
,,,,,,,,,,,,,,(,,,,,,,,(,,,,,,,,(,,,,,,,((,,,,,,,,,,,,,,,,,,,,,,,,,,,,#####,,,,#,,,,##,,,,,,,,,,,,,,,,,,,,,,,,,,,,,,,,,,
,,,,,,,,,,,,,(,,,,,,,,,,(,,,,,((,,,,,,,,,,(,,,,,,,,,,,,,,,,,,,,#######,,,,,,,,,,,,,,,,##########,,,,,,,,,,,,,,,,,,,,,,,,
,,,,,,,,,,,,,(,,,,,,,,,,,((,,(,,,,,,,,,*,,(,*,,,,,,,,,,,,,,,,,#,,,,,,,,,,,,,,######,,,,,,,,,,,,,,#,,,,,,,,,,,,,,,,,,,,,,
,,,,,,,,,,,,,,,(((,,,,,,,,,((,,,,,,,,,(*,,,,*,,,,,,,,,,,,,,,#,,,,,,,,,,,,,,,#,,,,,,#,,,,,,,,,,,,,,,#,,,,,,,,,,,,,,,,,,,,
,,,,,,,,,,,,,,,,,,,,(((,,,,((,,,,(*****,**,*,*****,,,,,,,,,,#,,,,,,,,,,,,,#,,,,,,,,,#,,,,,,,,,,,,,,#,,,,,,,,,,,,,,,,,,,,
,,,,,,,,,,,,,,,,,,,,,,,(,((,,(,,(*,,,,,,**,*,,,,,,**,,,,,,,,,#,,,,,,,,,,,#,,,,,,,,,,,,#,,,,,,,,,,,#,,,,,,,,,,,,,,,,,,,,,
,,,,,,,,,,,,,,,,,,((,,,,,,,,,,,,,,*****,**,*,*****,,,,,,,,,,,,,#########,,,,,,,,,,,,,,,,#########,,,,,,,,,,,,,,,,,,,,,,,
,,,,,,,,,,,,,,(,,,,,,,,,,((,,(,,,,,,,,,*((,,*,,,,,,,,,,,,,,,,,,,,,,,,,,,,,,,,,,,,,,,,,,,,,,,,,,,,,,,,,,,,,,,,,,,,,,,,,,,
,,,,,,,,,,,,,(,,,,,,,,,,(,,,,,((,,,,,,,*,,(,*,,,,,,,,,,,,,,,,,,,,,,,,,,,,,,,,,,,,,,,,,,,,,,,,,,,,,,,,,,,,,,,,,,,,,,,,,,,
,,,,,,,,,,,,,(,,,,,,,,,(,,,,,,,,(,,,,,,,,((,,,,,,,,,,,,,,,,,,,,,,,,,,,,,,,,,,,,,,,,,,,,,,,,,,,,,,,,,,,,,,,,,,,,,,,,,,,,,
,,,,,,,,,,,,,,,((((((((,,,,,,,,,,(((((((,,,,,,,,,,,,,,,,,,,,,,,,,,,,,,,,,,,,,,,,,,,,,,,,,,,,,,,,,,,,,,,,,,,,,,,,,,,,,,,,
,,,,,,,,,,,,,,,,,,,,,,,,,,,,,,,,,,,,,,,,,,,,,,,,,,,,,,,,,,,,,,,,,,,,,,,,,,,,,,,,,,,,,,,,,,,,,,,,,,,,,,,,,,,,,,,,,,,,,,,,
,,,,,,,,,,,,,,,,,,,,,,,,,,,,,,,,,,,,,,,,,,,,,,,,,,,,,,,,,,,,,,,,,,,,,,,,,,,,,,,,,,,,,,,,,,,,,,,%@@,,%@@,,,,,,,,,,,,,,,,,
,,,,,,,,,,,,,,,,,,,,,,,,,,,,,,,,,,,,,,,,,,,,,,,,,,,,,,,,,,,,,,,,,,,,,,,,,,,,,,,,,,,,,,,,,,,,,@@%#*##/*#@@(,,,,,,,,,,,,,,
,,,,,,,,,,,,,,,,,,,,,,,,,,,,,,,,,,,,,,,,,,,,,,,,,,,,,,,,,,@((((((@@,,,,,,,,,,,,,,,,,,,,,,,%@@#*(#@##&@#*#&@@,,,,,,,,,,,,
,,,,,,,,,,,,,,,,,,,,,,,,,,,,,,,,,,,,,,,,,,,,,,,,,,,,,,,&@(((((((((((@,,,,,,,,,,,,,,,,,,,,@%#*#@%#*##/*#@#/*#@,,,,,,,,,,,
,,,,,,,,,,,,,,,,,,,,,,,,,,,,,,,,,,,,,,,,,,,,,,,,,,,,,,,&@(((((((((((@,,,,,,,,,,,,,,,,,,,,,,,@#*(#@##&@#*#&@,,,,,,,,,,,,,
,,,,,,,,,,,,,,,,,,,,,,,,,,,,,,,,,,,,,,,,,,,,,,,,,,,,,,,&@(((((((((((@,,,,,,,,,,,,,,,,,,,,,,,,,@%#*##/*#@,,,,,,,,,,,,,,,,
,,,,,,,/,,,,,,,,,,/,,,,,,,,,/,,,,,,,,,/,,,,,,,,,/,,,,@@@@(/////////(@@/,,,,,,,,,*/,,,,,,,,,,@////////////&@,@/&@,,,,,,,/
,,,,/,,,,/,,,,/,,*,,//,*,//,,,//,,,//,,,//,,,//,,,//,@/(((/(((/((//((/&@,/,,,,/,,,,/,,,,/@(/////////////////@/&@/,,,,/,,
,,,,/,,,,/,,,,/,,*,*//,*,//,,,//,,,//,,,//,,,//,,,//,@/(((/(////(//((/&@,/,,,,/,,,,/,,,,/@(///,,,///////////@@(,/,,,,/,,
,,/,/,,/,/,,/@@@@%%%%%%%@@@@/,//,/,//,/,//,/,//,/,//,@/(((((////(((((/&@,/,//,/,*/,/,*/,/@(/////////////////@/*,/,/*,/,%
////////@@%%%%%%%%%%%%%%%%%%%%@@@////////////////////@(((((//////(((((@@/////////////////@(/////////////////@//////#%%%%
/////@@%%%%%%%%%%%%%%%%%%%%%%%%%%%@(/////////////////@((((((%%%%((((((@@/////////////////@(/////////////////@%%%%%%%%%% 
///@%%%%%%%%%%%%%%%%%%%%%%%%%%%%%%%%%@               @(((((%%%%%%#((((@@                 @(/////////////,*//@%%%%%%*    
@@%%%%%%%%%%%%%%%%%%%%%%%%%%%%%%%%%%%%%@.            @(((((%%%%%%#((((@@                 (((**//////////***((           
  @%%%%%%%%%%%%%%%%%%%%%%%%%%%%%%%%%%%@                &@@@@@@@@@@@@@                         ***(((((**                
     @@@@%%%%%%%%%%%%%%%%%%%%%%%@@@.                       ((((((.                               (((((                  
                  (((((                                    ((((((.                             *(((***(                 
                 (((((((                                                                      (/*(((/**(                
                 (((((((                                 (((((((((((                          (/*(*(((((                
               /(((((((((.                               (((((((((((                         (***((((((((,              
              (((((((((((((                                                                 **(((((****(*/(             
((((((((((((((((((((((((((((((((((((((((((((((((((((((((((((((((((((((((((((((((((((((((((((((((((((((((((((((((((((((((
((((((((((((((((((((((((((((((((((((((((((((((((((((((((((((((((((((((((((((((((((((((((((((((((((((((((((((((((((((((((
((((((((((((((((((((((((((((((((((((((((((((((((((((((((((((((((((((((((((((((((((((((((((((((((((((((((((((((((((((((((