                                                                     
            @@@@@                                                              
             @@##@@               @@@@                                         
               @@**@@        @@@@@@@  @@                                       
                 @@..@@@@  @@//***/@    @@@@@@@@@@                             
                   @@////@@@@//***/@      @@##**..@@@@                         
                     @@@@@@@@@@//*//&&  ..@@##**..//@@                     
                         @@      @@@@@@@@      @@##**..//%@                    
                         @@    @@  @     @     @@##**..**//%@@                  
                       @@      @@@@       @    @@##**..**//%%&&@@                  
                     @@pp                 @@    @@##**..*//%%&&@@                
                     @@pppp             @@@@    @@##**..*//%%&&@@              
                     @@pppppppp@@@@@@@@@        @@##**..*//%%&&@@              
                       @@@@@@@@       /@      @@##**..**//%%&&,,@@              
                                      @@  @@@@##**..**//#%%&&,,@@              
                                      @@@@####**..**//##%%&&,,@@              
                                      @@##**..*//##%%%%%$$&&,,@@              
                                  @@##**..****//##%%%%%%$$&,,@@                
                                @@##**..**//##%%%%%%%%$$&&&,,@@                
                                @@##**. **//##%%%%%%%%$$&&&,,@@                  
                               @@##**..**//##%%%%%%%%$$&&,,@@@                    
                               @@##**..**//##%%%%%&&,,@@@@                       
                                 @@##**..//**@@                                 
                                 @@##**..@@                                   
                                  @@##**@@                                   
                                    @@@@##**@@                                 
                                        @@@@@@                                 
                                                                               
                                                                               

